000000744480007807480000E00C0000
0780C0133320C01201320C00000E0780
0120B0000000B00000000B0748000160
0000B0000780B0C0000C0B01320000B0
00FA200C0560E0B0780B0B00000780B0
0000000B012000E0120E0B0C0E0560B0
07AAAD0B0000000000000E0B000120B0
0B00000B0FD0C00C00C0000B000000B0
0E07800E0000B0F3D0B0000B0C0000E0
000120000074600000B0FAA201AD0000
000000000013607480B0000000000000
000FAA800000B05960B0F807D0000000
0000005480C0B01320E00B0B00FAAD00
0007805320B0E00000000B0E00000000
0C0120B000E000FAAAA80B00007480C0
0E0000B000000000000B0E00001320B0
0000FA20780C0C0C0C0B0000000000B0
0FD00000560B0E0E0E01AAAAAAD000E0
00000000120B00000000000000000000
07800000000E0FAAD0780780C0744800
0560C0780000000000120120E0133200
0560B05607800780C000000000000000
0120B01205600120B007D0C0FAAAAAD0
0000E00001200000E0F2000000000000		
