00000015554000150155000050050000
01505025553050550554050000050150
05505000000050000000050114000550
00005000015050500005050532000050
00552005015050501405050000015050
00000005052000503205050505015050
01555505000000000000050500032050
05000005055050050050000500000050
05015005000050555050000505000050
00055000001550000050555203550000
00000000005550154050000000000000
00055540000050555050540150000000
00000035405050352050050500555500
00014013205050000000050500000000
05032050005000555554050000154050
05000050000000000005050000352050
00005520140505050505000000000050
05500000550505050503555555500050
00000000320500000000000000000000
01400000000505555014014050155400
05505014000000000032032050355200
05505055055001405000000000000000
03205032014003205001505055555550
00005000032000005052000000000000		
